NO ./textures/5.xpm
SO ./textures/5.xpm
WE ./textures/5.xpm
EA ./textures/5.xpm
F 255,255,255
C 80,150,135


111111111111111111111111111
100000000000000000000000001
100000000000000000000000001
100000000N00000000000000001
100000000000000000000000001
100000000000000000000000001
100000000000000000000000001
100000000000000000000000001
100000000000000000000000001
100000000000000000000000001
100000000000000000000000001
100000000000000000000000001
111111111111111111111111111
