NO ./textures/2.xpm
SO ./textures/2.xpm
WE ./textures/2.xpm
EA ./textures/2.xpm
F 75,0,150
C 80,150,135


111111111111111111111111111
100000000000001000000000001
100000000000000100000000001
111110000N00000010000000001
100000000000000001000000001
100000000000000000100000001
100000000000000000010000001
111111111000000000001000001
100000000000000000000100001
100000000000010000000010001
100000000000100000000001001
100000000001000000000000101
111111111111111111111111111
