NO 		./path_to_the_north_texture
WE   ./path_to_the_west_texture
SO				     ./path_to_the_south_texture

EA ./path_to_the_east_texture

C 50,100,240
F 120,100,0

 1 
1N1
101
101
101
101111111111
100000000001
100000000001
100000000001
111111000001
111111000001
111111000001
100000000001
100000000001
100000000001
111111000001
111111000001
111111000001
100000000001
100000000001
100000000001
111111000001
111111000001
111111000001
100000000001
100000000001
100000000001
111111000001
111111000001
111111000001
100000000001
100000000001
100000000001
111111000001
111111000001
111111000001
100000000001
100000000001
100000000001
111111000001
111111000001
111111000001
100000000001
100000000001
100000000001
111111000001
111111000001
111111000001
100000000001
100000000001
100000000001
111111000001
111111000001
111111000001
100000000001
100000000001
111111000001
111111000001
111111000001
100000000001
100000000001
111111000001
111111000001
111111000001
100000000001
111111000001
111111000001
111111000001
111111111111
