NO ./path_to_the_north_texture
SO ./path_to_the_south_texture
WE ./path_to_the_west_texture
EA ./path_to_the_east_texture

F 220,100,0
C 20,100,200

11111111111111111111111111111111111111
1000000000000000000000000000000000001
1000000000000000000000000000000000001
100000000000000000000000000000W00001
10000000000000000000000000000000001
1000000000000000000000000000000001
111111111111111111111111111000001
10000000000000000000000000000001
1000000000000000000000000000001
100000000000000000000000000001
11111111111111111111111111001
1000000000000000000000000001
100000000000000000000000001
10000000000000000000000001
1111111111111111111110001
100000000000000000000001
10000000000000000000001
1000000000000000000001
111111111111111110001
10000000000000000001
1000000000000000001
100000000000000001
11111111111110001
1000000000000001
100000000000001
10000000000001
1111111110001
100000000001
10000000001
1000000001
111110001
10000001
1000001
100001
10001
1001
101
11
1
