NO ./textures/1.xpm
SO ./textures/2.xpm
WE ./textures/3.xpm
EA ./textures/4.xpm

F 220,100,0
C 20,100,200

1111111111111111111111111111111111111111
1000000000000000000000000000000000001001
1000000000000000000000000000000000001001
100000000000000000000000000000W00001001
10000000000000000000000000000000001001
1000000000000000000000000000000001001
111111111111111111111111111000001001
10000000000000000000000000000001001
1000000000000000000000000000001001
100000000000000000000000000001001
11111111111111111111111111001001
1000000000000000000000000001001
100000000000000000000000001001
10000000000000000000000001001
1111111111111111111110001001
100000000000000000000001011
1000000000000000000000111
1000000000000000000001
111111111111111110001
10000000000000000001
1000000000000000001
100000000000000001
11111111111110001
1000000000000001
100000000000001
10000000000001
1111111110001
100000000001
10000000001
1000000001
111110001
10000001
1000001
100001
10001
1001
101
11
1
