NO ./textures/5.xpm
SO ./textures/5.xpm
WE ./textures/5.xpm
EA ./textures/5.xpm

F 255,255,255
C 255,255,255

11111111111111111111111111111111111111111111111111111111
1E000000000000000000000000000000000000000000000000000001
10111111101111111111111111111100000001111111111101100001
10000000000000000000000000000000000000000000000000000001
11111101011101111111000011111111000000001111101000100001
10000000000000000000000000000000000000000000000000000001
10000111111111111111111111000111111110001111110010110001
10000000000000000000000000000000000000000000000000000001
10000000000000000000000000000000000000000000000000000001
10000000000000000000000000000000000000000000000000000001
10000000000000000000000000000000000000000000000000000001
10000000000000000000000000000000000000000000000000000001
10000000000000000000000000000000000000000000000000000001
10000000000000000000000000000000000000000000000000000001
10111111101111111111111111111100000001111111111101100001
10000000000000000000000000000000000000000000000000000001
11111101011101111111000011111111000000001111101000100001
10000000000000000000000000000000000000000000000000000001
10000111111111111111111111000111111110001111110010110001
10000000000000000000000000000000000000000000000000000001
11111111111000011000001111111101111100000011101000101001
10000000000000000000000000000000000000000000000000000001
11111111111111111111111111111111111111111111111111111111
